~~~~~~~~~~~~~~~~~~~~~~~~~~~~~~
~     H                      ~
~                            ~
~             ~~~~           ~
~            E               ~
~~~                          ~
~        ~~~~~~~~~~~         ~
~     E~~           ~~E      ~
~         E# ### #E          ~
~        ~ # #S# # ~         ~
~          #  E  #           ~
~          #######           ~
~                      #     ~
~                     ###    ~
~             #              ~
~     #              #       ~   
~       #                    ~
~                #           ~
~                            ~
##############################
