~~~~~~~~~~~~~~~~~~~~~~~~~~~~~~
~                            ~
~                            ~
~                            ~
~                            ~
~#                           ~
~                            ~
~                            ~
~                            ~
~                            ~
~                            ~
~                            ~
~               ##### #######~
~               #HEE         ~
~               #EEE         ~
~               #E  S        ~
~                            ~
~                            ~
~                            ~
##############################
